xxxxxxxxxxxxxxxxxxxxxxxxxxxxxxxx
x                              x
x                              d
x                              d
x                         xxxxxx
x                    xx        p
x               xx             p
x                              p
x                              p
x                              x
x                              x
xxxxxxx                        x
xxxxxxppppppxxxxxxxxxxxxxx     x
p                              x
p                              x
p                              x
xxxxbxxxxxx              xxxxxxx
p                              p
p                              p
p                              p
p                              p
p                              p
xppepppppppppppppppppppppppppppx
xxxxxxxxxxxxxxxxxxxxxxxxxxxxxxxx
xxxxxxxxxxxxxxxxxxxxxxxxxxxxxxxx