xxxxxxxxxxxxxxxxxxxxxxxxxxxxxxxx
x                              p
d                              p
d                              p
xxxxxxxxxxxxxxxxxxxxxxxxx      x
x                              x
x                              x
x                              x
x                              x
x                              x
xpppp                          x
x                       x      x
x                       x      x
x                       x      x
x                x      x      x
x                x      x      x
x       x   x    x      x      x
x       x   x    x      x      x
x       x   x    x      x      x
x       x   x    x      x      x
x       x   x    x      x      x
x       x   x    x      x      x
xepppppxxpppxppppxppppppxppppppx
xxxxxxxxxxxxxxxxxxxxxxxxxxxxxxxx
xxxxxxxxxxxxxxxxxxxxxxxxxxxxxxxx