pppppppppppppppppppppppppppppppp
p       pppp                   p
p                              p
p                              p
p   xxx                        p
p                              p
d                              p
d                     xxxx     p
p                              p
p                              p
p                              d
p                              d
p                              p
p    xx                        p
p                              p
p                              p
p                      xxxx    p
p                              p
p                              p
p                              p
p                              p
p      pppp                    p
ppeppppppppppppppppppppppppppppp
pppppppppppppppppppppppppppppppp
pppppppppppppppppppppppppppppppp