xxxxxxxxxxxxxxxxxxxxxxxxxxxxxxxx
x       pppxxxxxpppxxxxxxxx    x
x                         x    d
x                         x    d
x                         xx   x
x                              x
x                             xx
x                            xxx
xpp             xxx      xx    x
x        x       x       x     x
x     x  x       x       x     x
x  x  x  x       x       x     x
x  xxpppppppppppppppppppppppxxxx
x                              x
x                              x
x                              x
xxxxxppppxxxxxxxxxx     xxxxxxxx
x                              x
x                              x
x                              x
x                              x
x                              x
xxxxexxxxxxxxxxxxxxxxxxxxppppppx
xxxxxxxxxxxxxxxxxxxxxxxxxxxxxxxx
xxxxxxxxxxxxxxxxxxxxxxxxxxxxxxxx